###################
#P................#
#.#####.##########
#.#...#.#........#
#.#.#.#.#.######.#
#.#.#.#.#.#....#.#
#.###.#.#.#.##.#.#
#.....#.#.#.##.#.#
#######.#.#.##.#.#
#.......#.#....#.#
#.#######.######.#
#.#.............#.#
#.#.###########.#.#
#...#.........#..E#
###################
