###############
#P............#
#.#####.######
#.#...#.#....#
#.#.#.#.#.##.#
#.#.#.#.#.##.#
#.###.#.#.##.#
#.....#.#....#
#######.######
#.............#
#.###########.#
#.#.........#.#
#.#.#######.#.#
#...#.....#..E#
###############
